DB - Wałbrzych (town)
DBA - Wałbrzych (district)
DBL - Bolesławiec
DDZ - Dzierżoniów
DGL - Głogów
DGR - Góra
DJ - Jelenia Góra (town)
DJA - Jawor
DJE - Jelenia Góra (district)
DKA - Kamienna Góra
DKL - Kłodzko
DL - Legnica (town)
DLB - Lubań
DLE - Legnica (district)
DLU - Lubin
DLW - Lwówek Śląski
DMI - Milicz
DOA - Oława
DOL - Oleśnica
DPL - Polkowice
DSR - Środa Śląska
DST - Strzelin
DSW - Świdnica
DTR - Trzebnica
DW - Wrocław (town)
DWL - Wołów
DWR - Wrocław (district)
DZA - Ząbkowice Śląskie
DZG - Zgorzelec
DZL - Złotoryja
CAL - Aleksandrów Kujawski
CB - Bydgoszcz (town)
CBR - Brodnica
CBY - Bydgoszcz (district)
CCH - Chełmno
CG - Grudziądz (town)
CGD - Golub-Dobrzyń
CGR - Grudziądz (district)
CIN - Inowrocław
CLI - Lipno
CMG - Mogilno
CNA - Nakło n. Notecią
CRA - Radziejów
CRY - Rypin
CSE - Sepólno Krajenskie
CSW - Świecie
CT - Toruń (town)
CTR - Toruń (district)
CTU - Tuchola
CW - Włocławek (town)
CWA - Wąbrzeźno
CWL - Włocławek (district)
CZN - Żnin
EBE - Bełchatów
EBR - Brzeziny
EKU - Kutno
EL - Łódź (town)
ELA - Łask
ELC - Łowicz
ELE - Łęczyca
ELW - Łódź Wschód
EOP - Opoczno
EP - Piotrków Trybunalski (town)
EPA - Pabianice
EPD - Poddębice
EPI - Piotrków Trybunalski (district)
EPJ - Pajęczno
ERA - Radomsko
ERW - Rawa Mazowiecka
ES - Skierniewice (town)
ESI - Sieradz
ESK - Skierniewice (district)
ETM - Tomaszów Mazowiecki
EWE - Wieruszów
EWI - Wieluń
EZD - Zduńska Wola
EZG - Zgierz
LB - Biała Podlaska (town)
LBI - Biała Podlaska (district)
LBL - Biłgoraj
LC - Chełm (town)
LCH - Chełm (district)
LHR - Hrubieszów
LJA - Janów Lubelski
LKR - Kraśnik
LKS - Krasnystaw
LLB - Lubartów
LLE - Łęczna
LLU - Łuków
LOP - Opole Lubelskie
LPA - Parczew
LPU - Puławy
LRA - Radzyń Podlaski
LRY - Ryki
LSW - Świdnik
LTM - Tomaszów Lubelski
LU - Lublin (town)
LUB - Lublin (district)
LWL - Włodawa
LZ - Zamość (town)
LZA - Zamość (district)
FG - Gorzów Wielkopolski (town)
FGW - Gorzów Wielkopolski (district)
FKR - Krosno Odrzańskie
FMI - Międzyrzecz
FNW - Nowa Sól
FSD - Strzelce Kraj. - Drezdenko
FSL - Słubice
FSU - Sulęcin
FSW - Świebodzin
FWS - Wschowa
FZ - Zielona Góra (town)
FZA - Żary
FZG - Żagań
FZI - Zielona Góra (district)
KBC - Bochnia
KBR - Brzesko
KCH - Chrzanów
KDA - Dąbrowa Tarnowska
KGR - Gorlice
KLI - Limanowa
KMI - Miechów
KMY - Myślenice
KN - Nowy Sącz (town)
KNS - Nowy Sącz (district)
KNT - Nowy Targ
KOL - Olkusz
KOS - Oświęcim
KPR - Proszowice
KR - Kraków (town)
KRA - Kraków (district)
KSU - Sucha Beskidzka
KT - Tarnów (town)
KTA - Tarnów (district)
KTT - Tatrzański (Zakopane)
KWA - Wadowice
KWI - Wieliczka
WA - Warsaw (Białołęka)
WB - Warsaw (Bemowo)
WBR - Białobrzegi
WCI - Ciechanów
WD - Warsaw (Bielany)
WE - Warsaw (Mokotów)
WF - Warsaw (Praga Południe)
WG - Garwolin
WGM - Grodzisk Mazowiecki
WGR - Grójec
WGS - Gostynin
WH - Warsaw (Praga Północ)
WI - Warsaw (Śródmieście)
WJ - Warsaw (Targówek)
WK - Warsaw (Ursus)
WKZ - Kozienice
WL - Legionowo
WLI - Lipsko
WLS - Łosice
WM - Mińsk Mazowiecki
WMA - Maków Mazowiecki
WML - Mława
WN - Warsaw (Ursynów)
WND - Nowy Dwór Mazowiecki
WO - Ostrołęka (town)
WOR - Ostrów Mazowiecka
WOS - Ostrołęka (district)
WOT - Otwock
WP - Płock (town)
WPI - Piaseczno
WPL - Płock (district)
WPN - Płońsk
WPR - Pruszków
WPU - Pułtusk
WPY - Przysucha
WPZ - Przasnysz
WR - Radom (town)
WRA - Radom (district)
WS - Siedlce (town)
WSC - Sochaczew
WSE - Sierpc
WSI - Siedlce (district)
WSK - Sokołów Podlaski
WSZ - Szydłowiec
WT - Warsaw (Wawer)
WU - Warsaw (Ochota)
WV - Wołomin (not issued yet)
WWE - Węgrów
WWL - Wołomin
WWY - Wyszków
WX - Warsaw (Żoliborz)
WX ***Y# - Warsaw (Wesoła)
WY - Warsaw (Wola)
WZ - Warszawski Zachodni (Ożarów Mazowiecki)
WZU - Żuromin
WZW - Zwoleń
WZY - Żyrardów
OB - Brzeg
OGL - Głubczyce
OK - Kędzierzyn-Koźle
OKL - Kluczbork
OKR - Krapkowice
ONA - Namysłów
ONY - Nysa
OOL - Olesno
OP - Opole (town)
OPO - Opole (district)
OPR - Prudnik
OST - Strzelce Opolskie
RBI - Bieszczadzki (Ustrzyki Dolne)
RBR - Brzozów
RDE - Dębica
RJA - Jarosław
RJS - Jasło
RK - Krosno (town)
RKL - Kolbuszowa
RKR - Krosno (district)
RLA - Łańcut
RLE - Leżajsk
RLS - Lesko
RLU - Lubaczów
RMI - Mielec
RNI - Nisko
RP - Przemyśl (town)
RPR - Przemyśl (district)
RPZ - Przeworsk
RRS - Ropczyce - Sędziszów
RSA - Sanok
RSR - Strzyżów
RST - Stalowa Wola
RT - Tarnobrzeg (town)
RTA - Tarnobrzeg (district)
RZ - Rzeszów (city)
RZE - Rzeszów (district)
BAU - Augustów
BBI - Bielsk Podlaski
BGR - Grajewo
BHA - Hajnówka
BI - Białystok (town)
BIA - Białystok (district)
BKL - Kolno
BL - Łomża (town)
BLM - Łomża (district)
BMN - Monki
BS - Suwałki (town)
BSE - Sejny
BSI - Siemiatycze
BSK - Sokółka
BSU - Suwałki (district)
BWM - Wysokie Mazowieckie
BZA - Zambrów
GA - Gdynia
GBY - Bytów
GCH - Chojnice
GCZ - Człuchów
GD - Gdańsk (town)
GDA - Gdańsk (Pruszcz Gdański)
GKA - Kartuzy
GKS - Kościerzyna
GKW - Kwidzyń
GLE - Lębork
GMB - Malbork
GND - Nowy Dwór Gdański
GPU - Puck
GS - Słupsk (town)
GSL - Słupsk (district)
GSP - Sopot
GST - Starogard Gdański
GSZ - Sztum
GTC - Tczew
GWE - Wejherowo
SB - Bielsko-Biała (town)
SBE - Będzin
SBI - Bielsko-Biała (district)
SBL - Bieruń - Lędziny
SC - Częstochowa (town)
SCI - Cieszyn
SCZ - Częstochowa (district)
SD - Dąbrowa Górnicza
SG - Gliwice (town)
SGL - Gliwice (district)
SH - Chorzów
SI - Siemianowice Śląskie
SJ - Jaworzno
SJZ - Jastrzębie-Zdrój
SK - Katowice
SKL - Kłobuck
SL - Ruda Śląska
SLU - Lubliniec
SM - Mysłowice
SMI - Mikołów
SMY - Myszków
SO - Sosnowiec
SPI - Piekary Śląskie
SPS - Pszczyna
SR - Rybnik (town)
SRB - Rybnik (district)
SRC - Racibórz
SL - Ruda Śląska
ST - Tychy (town)
STA - Tarnowskie Góry
STY - Tychy (district)
SW - Świętochłowice
SWD - Wodzisław Śląski
SY - Bytom
SZ - Zabrze
SZA - Zawiercie
SZO - Żory
SZY - Żywiec
TBU - Busko-Zdrój
TJE - Jędrzejów
TK - Kielce (town)
TKA - Kazimierza Wielka
TKI - Kielce (district)
TKN - Końskie
TLW - Włoszczowa
TOP - Opatów
TOS - Ostrowiec Świętokrzyski
TPI - Pińczów
TSA - Sandomierz
TSK - Skarżysko-Kamienna
TST - Starachowice
TSZ - Staszów
NBA - Bartoszyce
NBR - Braniewo
NDZ - Działdowo
NE - Elbląg (town)
NEB - Elbląg (district)
NEL - Ełk
NGI - Giżycko
NGO - Gołdap
NIL - Iława
NKE - Kętrzyn
NLI - Lidzbark Warmiński
NMR - Mrągowo
NNI - Nidzica
NNM - Nowe Miasto Lubawskie
NO - Olsztyn (town)
NOE - Olecko
NOG - Olecko and Gołdap (now NOE and NGO)
NOL - Olsztyn (district)
NOS - Ostróda
NPI - Pisz
NSZ - Szczytno
NWE - Węgorzewo
PCH - Chodzież
PCT - Czarnków - Trzcianka
PGN - Gniezno
PGO - Grodzisk Wielkopolski
PGS - Gostyń
PJA - Jarocin
PK - Kalisz (town)
PKA - Kalisz (district)
PKE - Kępno
PKL - Koło
PKN - Konin (district)
PKO - Konin (town) now PN
PKR - Krotoszyn
PKS - Kościan
PL - Leszno (town)
PLE - Leszno (district)
PMI - Międzychód
PN - Konin (town)
PNT - Nowy Tomyśl
PO, PY - Poznań (town)
POB - Oborniki
POS - Ostrów Wielkopolski
POT - Ostrzeszów
POZ - Poznań (district) now PZ
PP - Piła
PPL - Pleszew
PRA - Rawicz
PSE - Śrem
PSL - Słupca
PSR - Środa Wlkp.
PSZ - Szamotuły
PTU - Turek
PWA - Wągrowiec
PWL - Wolsztyn
PWR - Września
PZ - Poznań (district)
PZL - Złotów
ZBI - Białogard
ZCH - Choszczno
ZDR - Drawsko Pomorskie
ZGL - Goleniów
ZGR - Gryfino
ZGY - Gryfice
ZK - Koszalin (town)
ZKA - Kamień Pomorski
ZKL - Kołobrzeg
ZKO - Koszalin (district)
ZLO - Łobez
ZMY - Myślibórz
ZPL - Police (district)
ZPY - Pyrzyce
ZS - Szczecin
ZSD - Świdwin
ZSL - Sławno
ZST - Stargard Szczeciński
ZSW - Świnoujście
ZSZ - Szczecinek
ZWA - Wałcz